11111
1CEP1
1C101
10111
10111
10111
1C001
1C101
11111